0000011100000000
0000000101110000
0000000101010000
0011110100010000
1000010111110000
1001010000010000
1011110000010000
0000100000000000
0000000000000000